2007_000504
2007_000904
2007_001073
2007_001764
2007_001917
2007_002088
2007_002669
2007_002789
2007_004081
2007_004500
2007_004537
2007_005124
2007_005797
2007_007772
2007_009082
2008_000335
2008_000711
2008_000876
2008_000905
2008_000964
2008_001062
2008_001359
2008_001653
2008_002278
2008_002732
2008_003065
2008_003094
2008_003256
2008_003297
2008_004394
2008_004841
2008_005010
2008_005375
2008_005714
2008_006210
2008_006290
2008_006355
2008_006496
2008_006547
2008_006827
2008_006880
2008_006904
2008_007009
2008_007014
2008_007026
2008_007398
2008_007544
2008_007586
2008_007666
2008_007729
2008_007932
2008_008115
2008_008121
2008_008132
2008_008169
2008_008199
2008_008241
2008_008428
2008_008437
2008_008521
2008_008541
2008_008617
2008_008654
2008_008675
2008_008685
2009_000066
2009_000091
2009_000250
2009_000285
2009_000471
2009_000472
2009_000559
2009_000574
2009_000626
2009_000632
2009_000694
2009_000709
2009_000768
2009_000899
2009_000971
2009_001079
2009_001104
2009_001134
2009_001145
2009_001163
2009_001257
2009_001413
2009_001475
2009_001518
2009_001673
2009_001798
2009_001873
2009_002002
2009_002019
2009_002118
2009_002136
2009_002229
2009_002360
2009_002422
2009_002472
2009_002510
2009_002518
2009_002542
2009_002588
2009_002597
2009_002648
2009_002708
2009_002772
2009_002869
2009_002901
2009_002912
2009_003089
2009_003146
2009_003173
2009_003189
2009_003218
2009_003297
2009_003455
2009_003510
2009_003521
2009_003634
2009_003825
2009_003901
2009_003933
2009_003956
2009_003975
2009_004169
2009_004186
2009_004233
2009_004284
2009_004289
2009_004316
2009_004351
2009_004366
2009_004451
2009_004679
2009_004787
2009_004929
2009_005068
2009_005081
2009_005229
2009_005307
2010_000063
2010_000498
2010_000545
2010_000548
2010_000808
2010_000910
2010_001317
2010_001406
2010_001548
2010_001671
2010_001694
2010_001803
2010_001937
2010_002018
2010_002047
2010_002133
2010_002139
2010_002254
2010_002320
2010_002716
2010_002797
2010_002834
2010_002905
2010_003011
2010_003016
2010_003201
2010_003345
2010_003383
2010_003507
2010_003821
2010_003970
2010_004140
2010_004163
2010_004210
2010_004264
2010_004283
2010_004436
2010_004456
2010_004598
2010_004655
2010_005031
2010_005061
2010_005062
2010_005223
2010_005258
2010_005276
2010_005297
2010_005424
2010_005458
2010_005468
2010_005562
2010_005668
2010_005824
2010_005993
2011_000057
2011_000069
2011_000109
2011_000166
2011_000219
2011_000299
2011_000309
2011_000763
2011_000778
2011_000784
2011_001079
2011_001163
2011_001282
2011_001318
2011_001333
2011_001354
2011_001399
2011_001424
2011_001653
2011_001679
2011_001805
2011_001840
2011_001854
2011_001942
2011_001950
2011_002018
2011_002019
2011_002134
2011_002189
2011_002272
2011_002584
2011_002609
2011_002649
2011_002719
2011_002864
2011_002873
2011_002937
2011_003016
2011_003043
