2007_001149
2007_001420
2007_002361
2007_002967
2007_003189
2007_003778
2007_004081
2007_004707
2007_004948
2007_006303
2007_006605
2007_007890
2007_008043
2007_008140
2007_008821
2007_009630
2008_000188
2008_000196
2008_000274
2008_000287
2008_000491
2008_000564
2008_000790
2008_000841
2008_000857
2008_000916
2008_000923
2008_000960
2008_001133
2008_001451
2008_001460
2008_001467
2008_001784
2008_001862
2008_001865
2008_002026
2008_002191
2008_002317
2008_002653
2008_003225
2008_003320
2008_003434
2008_003466
2008_003523
2008_003547
2008_003636
2008_003665
2008_003726
2008_003767
2008_003768
2008_003815
2008_003838
2008_003978
2008_004002
2008_004003
2008_004092
2008_004171
2008_004380
2008_004428
2008_004435
2008_004497
2008_004615
2008_004619
2008_004634
2008_004661
2008_004756
2008_004977
2008_005001
2008_005040
2008_005042
2008_005111
2008_005146
2008_005214
2008_005345
2008_005417
2008_005501
2008_005511
2008_005519
2008_005608
2008_005794
2008_005798
2008_005847
2008_005874
2008_005897
2008_005914
2008_005954
2008_006068
2008_006112
2008_006203
2008_006207
2008_006262
2008_006295
2008_006337
2008_006441
2008_006524
2008_006534
2008_006543
2008_006562
2008_006751
2008_006796
2008_006807
2008_006816
2008_006828
2008_006864
2008_006881
2008_006950
2008_007042
2008_007108
2008_007223
2008_007226
2008_007281
2008_007388
2008_007461
2008_007525
2008_007621
2008_007701
2008_007823
2008_007831
2008_007835
2008_007973
2008_007977
2008_008024
2008_008070
2008_008096
2008_008184
2008_008208
2008_008235
2008_008237
2008_008310
2008_008330
2008_008331
2008_008341
2008_008363
2008_008517
2008_008531
2008_008608
2008_008621
2008_008641
2008_008689
2009_000158
2009_000198
2009_000297
2009_000419
2009_000526
2009_000590
2009_000624
2009_000635
2009_000760
2009_000867
2009_000926
2009_001085
2009_001100
2009_001137
2009_001229
2009_001249
2009_001417
2009_001440
2009_001514
2009_001627
2009_001667
2009_001704
2009_001806
2009_001864
2009_001888
2009_001922
2009_001934
2009_001975
2009_002088
2009_002123
2009_002386
2009_002433
2009_002444
2009_002628
2009_002670
2009_002688
2009_002698
2009_002741
2009_002755
2009_002817
2009_002935
2009_002952
2009_003039
2009_003074
2009_003077
2009_003238
2009_003288
2009_003301
2009_003351
2009_003384
2009_003440
2009_003476
2009_003642
2009_003654
2009_003677
2009_003679
2009_003697
2009_003815
2009_003888
2009_003929
2009_004025
2009_004050
2009_004051
2009_004093
2009_004191
2009_004263
2009_004274
2009_004283
2009_004394
2009_004404
2009_004426
2009_004438
2009_004514
2009_004532
2009_004537
2009_004554
2009_004631
2009_004642
2009_004645
2009_004745
2009_004794
2009_004869
2009_004885
2009_004901
2009_004919
2009_004983
2009_004990
2009_005008
2009_005069
2009_005070
2009_005165
2009_005170
2009_005278
2009_005286
2009_005310
2010_000015
2010_000027
2010_000132
2010_000202
2010_000399
2010_000470
2010_000567
2010_000601
2010_000669
2010_000737
2010_000773
2010_000800
2010_000871
2010_000876
2010_000973
2010_001111
2010_001134
2010_001219
2010_001310
2010_001479
2010_001544
2010_001717
2010_001743
2010_001787
2010_001843
2010_001864
2010_001940
2010_002193
2010_002195
2010_002316
2010_002366
2010_002379
2010_002462
2010_002537
2010_002605
2010_002661
2010_002676
2010_002742
2010_002830
2010_002982
2010_003017
2010_003101
2010_003103
2010_003203
2010_003218
2010_003390
2010_003556
2010_003651
2010_003667
2010_003674
2010_003728
2010_003729
2010_003910
2010_004062
2010_004072
2010_004224
2010_004358
2010_004466
2010_004683
2010_004908
2010_004910
2010_004944
2010_004974
2010_004982
2010_005158
2010_005274
2010_005279
2010_005455
2010_005536
2010_005593
2010_005758
2010_005830
2010_005930
2010_005932
2010_005975
2011_000072
2011_000145
2011_000196
2011_000361
2011_000388
2011_000468
2011_000514
2011_000530
2011_000572
2011_000731
2011_000743
2011_000823
2011_000875
2011_000885
2011_000919
2011_000934
2011_000957
2011_001009
2011_001011
2011_001022
2011_001034
2011_001055
2011_001221
2011_001226
2011_001360
2011_001369
2011_001382
2011_001440
2011_001456
2011_001600
2011_001611
2011_001689
2011_001766
2011_001820
2011_001845
2011_001946
2011_002022
2011_002031
2011_002318
2011_002386
2011_002443
2011_002614
2011_002808
2011_002810
2011_002924
2011_002978
2011_003002
2011_003047
2011_003162
