2007_001416
2007_001872
2007_002845
2007_003190
2007_003593
2007_004423
2007_004768
2007_006136
2007_006832
2007_006899
2007_006944
2007_007048
2007_007230
2007_007621
2008_000084
2008_000099
2008_000669
2008_001601
2008_002061
2008_002150
2008_002343
2008_002430
2008_003147
2008_004007
2008_004629
2008_005447
2008_005494
2008_005505
2008_005635
2008_005706
2008_005736
2008_005938
2008_005987
2008_006059
2008_006070
2008_006100
2008_006221
2008_006339
2008_006477
2008_006570
2008_006892
2008_006939
2008_007069
2008_007070
2008_007245
2008_007334
2008_007430
2008_007693
2008_007806
2008_007890
2008_007909
2008_007985
2008_008109
2008_008319
2008_008322
2008_008323
2008_008601
2008_008613
2008_008623
2008_008665
2008_008666
2008_008714
2008_008744
2009_000168
2009_000223
2009_000289
2009_000356
2009_000670
2009_000725
2009_000750
2009_000837
2009_001172
2009_001177
2009_001203
2009_001236
2009_001263
2009_001349
2009_001403
2009_001537
2009_001618
2009_001643
2009_001699
2009_001732
2009_001738
2009_001783
2009_001959
2009_002133
2009_002245
2009_002282
2009_002391
2009_002719
2009_002921
2009_002988
2009_003076
2009_003249
2009_003254
2009_003271
2009_003425
2009_003430
2009_003460
2009_003541
2009_003618
2009_003624
2009_003784
2009_004164
2009_004171
2009_004181
2009_004222
2009_004513
2009_004547
2009_004706
2009_004768
2009_004805
2009_004834
2009_004943
2009_004945
2009_005005
2009_005193
2010_000002
2010_000052
2010_000089
2010_000117
2010_000139
2010_000189
2010_000190
2010_000307
2010_000327
2010_000390
2010_000436
2010_000483
2010_000527
2010_000562
2010_000641
2010_000667
2010_000727
2010_000735
2010_000822
2010_000831
2010_000847
2010_000866
2010_000920
2010_000970
2010_000978
2010_001076
2010_001082
2010_001160
2010_001175
2010_001245
2010_001257
2010_001286
2010_001356
2010_001607
2010_001746
2010_001796
2010_001881
2010_001987
2010_002039
2010_002041
2010_002058
2010_002113
2010_002124
2010_002130
2010_002176
2010_002215
2010_002294
2010_002346
2010_002353
2010_002378
2010_002501
2010_002507
2010_002518
2010_002582
2010_002624
2010_002628
2010_002665
2010_002705
2010_002736
2010_002737
2010_002821
2010_003013
2010_003028
2010_003074
2010_003094
2010_003102
2010_003153
2010_003253
2010_003343
2010_003372
2010_003376
2010_003429
2010_003491
2010_003567
2010_003725
2010_003742
2010_003754
2010_003761
2010_003774
2010_003792
2010_003806
2010_003865
2010_003919
2010_003939
2010_003954
2010_003996
2010_004061
2010_004065
2010_004067
2010_004074
2010_004089
2010_004105
2010_004188
2010_004225
2010_004259
2010_004332
2010_004428
2010_004431
2010_004436
2010_004499
2010_004514
2010_004560
2010_004629
2010_004659
2010_004694
2010_004704
2010_004710
2010_004812
2010_004868
2010_005002
2010_005026
2010_005066
2010_005098
2010_005120
2010_005183
2010_005260
2010_005285
2010_005310
2010_005385
2010_005416
2010_005466
2010_005514
2010_005519
2010_005566
2010_005567
2010_005601
2010_005635
2010_005688
2010_005736
2010_005740
2010_005767
2010_005986
2011_000102
2011_000332
2011_000404
2011_000450
2011_000454
2011_000641
2011_000759
2011_000829
2011_000834
2011_001240
2011_001246
2011_001329
2011_001373
2011_001549
2011_001757
2011_001822
2011_001986
2011_002027
2011_002119
2011_002169
2011_002447
2011_002464
2011_002553
2011_002571
2011_002817
2011_003023
2011_003223
