2007_000241
2007_000713
2007_001698
2007_002234
2007_002403
2007_003910
2007_006281
2007_006490
2007_006660
2007_006673
2007_007415
2007_008219
2007_008571
2007_009527
2007_009533
2007_009947
2008_000007
2008_000036
2008_000140
2008_000195
2008_000235
2008_000262
2008_000405
2008_000414
2008_000423
2008_000437
2008_000471
2008_000505
2008_000567
2008_000833
2008_000834
2008_000957
2008_001041
2008_001047
2008_001056
2008_001136
2008_001159
2008_001160
2008_001167
2008_001202
2008_001389
2008_001420
2008_001516
2008_001529
2008_001575
2008_001620
2008_001649
2008_001652
2008_001843
2008_001849
2008_001858
2008_001970
2008_001977
2008_001987
2008_002046
2008_002131
2008_002194
2008_002250
2008_002335
2008_002610
2008_002625
2008_002773
2008_002850
2008_002887
2008_002966
2008_003062
2008_003081
2008_003100
2008_003112
2008_003187
2008_003313
2008_003362
2008_003402
2008_003449
2008_003458
2008_003480
2008_003652
2008_003701
2008_003840
2008_003849
2008_003870
2008_003913
2008_003988
2008_004014
2008_004026
2008_004053
2008_004124
2008_004242
2008_004291
2008_004469
2008_004570
2008_004636
2008_004718
2008_004812
2008_004904
2008_004920
2008_004921
2008_004969
2008_004983
2008_005063
2008_005071
2008_005108
2008_005244
2008_005321
2008_005359
2008_005367
2008_005502
2008_005504
2008_005512
2008_005517
2008_005526
2008_005536
2008_005541
2008_005593
2008_005610
2008_005683
2008_005695
2008_005720
2008_005764
2008_005855
2008_005863
2008_005923
2008_006046
2008_006065
2008_006094
2008_006121
2008_006185
2008_006289
2008_006349
2008_006404
2008_006407
2008_006487
2008_006489
2008_006490
2008_006586
2008_006730
2008_006767
2008_006824
2008_006825
2008_006831
2008_006833
2008_006877
2008_006903
2008_006925
2008_006949
2008_006961
2008_007056
2008_007101
2008_007156
2008_007305
2008_007382
2008_007425
2008_007441
2008_007574
2008_007597
2008_007599
2008_007643
2008_007653
2008_007750
2008_007755
2008_007841
2008_007883
2008_007884
2008_007953
2008_007966
2008_008083
2008_008170
2008_008235
2008_008616
2009_000093
2009_000120
2009_000305
2009_000378
2009_000385
2009_000420
2009_000477
2009_000491
2009_000516
2009_000686
2009_000690
2009_000752
2009_000829
2009_000830
2009_000996
2009_001019
2009_001282
2009_001289
2009_001406
2009_001407
2009_001544
2009_001567
2009_001715
2009_001770
2009_001794
2009_001949
2009_002096
2009_002127
2009_002146
2009_002173
2009_002289
2009_002306
2009_002308
2009_002343
2009_002358
2009_002397
2009_002449
2009_002506
2009_002530
2009_002543
2009_002577
2009_002662
2009_002759
2009_002778
2009_002830
2009_002897
2009_002946
2009_003010
2009_003019
2009_003032
2009_003136
2009_003150
2009_003247
2009_003284
2009_003345
2009_003351
2009_003400
2009_003482
2009_003511
2009_003600
2009_003652
2009_003936
2009_004007
2009_004078
2009_004148
2009_004166
2009_004178
2009_004224
2009_004273
2009_004278
2009_004397
2009_004524
2009_004539
2009_004780
2009_004786
2009_004904
2009_005006
2009_005015
2009_005118
2009_005239
2010_000024
2010_000145
2010_000195
2010_000382
2010_000630
2010_000710
2010_000748
2010_000803
2010_000887
2010_001126
2010_001212
2010_001289
2010_001456
2010_001501
2010_001525
2010_001551
2010_001729
2010_001749
2010_001807
2010_001899
2010_001916
2010_001967
2010_002117
2010_002216
2010_002315
2010_002321
2010_002364
2010_002393
2010_002498
2010_002565
2010_002620
2010_002653
2010_002702
2010_002780
2010_002899
2010_003027
2010_003103
2010_003107
2010_003117
2010_003203
2010_003260
2010_003508
2010_003599
2010_003604
2010_003640
2010_003644
2010_003679
2010_003757
2010_003815
2010_003860
2010_003878
2010_003899
2010_004006
2010_004081
2010_004124
2010_004253
2010_004486
2010_004561
2010_004567
2010_004576
2010_004714
2010_004773
2010_004852
2010_004950
2010_005192
2010_005198
2010_005332
2010_005364
2010_005588
2010_005597
2010_005780
2010_005927
2011_000086
2011_000130
2011_000161
2011_000278
2011_000286
2011_000342
2011_000347
2011_000556
2011_000631
2011_000683
2011_000744
2011_000749
2011_000839
2011_000986
2011_001001
2011_001029
2011_001097
2011_001160
2011_001176
2011_001221
2011_001252
2011_001310
2011_001384
2011_001557
2011_001582
2011_001592
2011_001710
2011_001771
2011_001901
2011_001961
2011_002036
2011_002050
2011_002073
2011_002421
2011_002459
2011_002490
2011_002558
2011_002588
2011_002661
2011_002677
2011_002740
2011_002821
2011_002871
2011_002912
2011_002943
2011_003020
2011_003025
2011_003041
2011_003081
2011_003232
