2007_000170
2007_000250
2007_001185
2007_001602
2007_002953
2007_003207
2007_003431
2007_004291
2007_004476
2007_007021
2007_007250
2007_008778
2007_009709
2008_000015
2008_000023
2008_000034
2008_000112
2008_000145
2008_000154
2008_000290
2008_000522
2008_000787
2008_000851
2008_001077
2008_001199
2008_001230
2008_001304
2008_001307
2008_001405
2008_001431
2008_001444
2008_001593
2008_001737
2008_001744
2008_001837
2008_001910
2008_002002
2008_002005
2008_002153
2008_002292
2008_002311
2008_002362
2008_002372
2008_002606
2008_002870
2008_003079
2008_003186
2008_003200
2008_003276
2008_003289
2008_003463
2008_003467
2008_003579
2008_003591
2008_003635
2008_003722
2008_003969
2008_004016
2008_004037
2008_004090
2008_004126
2008_004145
2008_004178
2008_004308
2008_004418
2008_004501
2008_004564
2008_004607
2008_004666
2008_004898
2008_004926
2008_004934
2008_004937
2008_004948
2008_004979
2008_004982
2008_005023
2008_005140
2008_005182
2008_005204
2008_005324
2008_005342
2008_005560
2008_005758
2008_005867
2008_005869
2008_005881
2008_005939
2008_005945
2008_005991
2008_006004
2008_006024
2008_006027
2008_006052
2008_006072
2008_006104
2008_006111
2008_006120
2008_006136
2008_006144
2008_006182
2008_006192
2008_006282
2008_006295
2008_006427
2008_006558
2008_006585
2008_006605
2008_006641
2008_006657
2008_006701
2008_006731
2008_006792
2008_006815
2008_006890
2008_006941
2008_006969
2008_007058
2008_007076
2008_007134
2008_007142
2008_007168
2008_007261
2008_007361
2008_007394
2008_007528
2008_007585
2008_007591
2008_007664
2008_007697
2008_007704
2008_007724
2008_007858
2008_007923
2008_007954
2008_008330
2008_008694
2008_008700
2009_000058
2009_000130
2009_000247
2009_000257
2009_000277
2009_000340
2009_000377
2009_000414
2009_000463
2009_000494
2009_000502
2009_000546
2009_000562
2009_000742
2009_000763
2009_000783
2009_000797
2009_000867
2009_000992
2009_001011
2009_001024
2009_001054
2009_001059
2009_001103
2009_001120
2009_001154
2009_001207
2009_001224
2009_001309
2009_001328
2009_001339
2009_001398
2009_001414
2009_001480
2009_001494
2009_001593
2009_001625
2009_001640
2009_001705
2009_001720
2009_001743
2009_001799
2009_001810
2009_001848
2009_001907
2009_001908
2009_001933
2009_001937
2009_002060
2009_002089
2009_002137
2009_002204
2009_002235
2009_002328
2009_002464
2009_002475
2009_002567
2009_002579
2009_002620
2009_002675
2009_002814
2009_002850
2009_002940
2009_002980
2009_002984
2009_003034
2009_003114
2009_003142
2009_003191
2009_003347
2009_003349
2009_003468
2009_003562
2009_003588
2009_003609
2009_003629
2009_003664
2009_003720
2009_003793
2009_003795
2009_003818
2009_003865
2009_003888
2009_003899
2009_003914
2009_003958
2009_004031
2009_004085
2009_004112
2009_004122
2009_004162
2009_004199
2009_004228
2009_004332
2009_004432
2009_004542
2009_004656
2009_004745
2009_004749
2009_004764
2009_004856
2009_005044
2009_005150
2009_005308
2010_000050
2010_000131
2010_000137
2010_000213
2010_000310
2010_000325
2010_000352
2010_000386
2010_000591
2010_000697
2010_000721
2010_000805
2010_000897
2010_000915
2010_001013
2010_001131
2010_001188
2010_001219
2010_001224
2010_001463
2010_001535
2010_001680
2010_001698
2010_001785
2010_001819
2010_001877
2010_001884
2010_002244
2010_002269
2010_002373
2010_002388
2010_002440
2010_002455
2010_002520
2010_002539
2010_002668
2010_002772
2010_002843
2010_002858
2010_002931
2010_002941
2010_002956
2010_003017
2010_003037
2010_003092
2010_003199
2010_003304
2010_003329
2010_003512
2010_003538
2010_003539
2010_003625
2010_003762
2010_003779
2010_003994
2010_004054
2010_004197
2010_004288
2010_004290
2010_004344
2010_004441
2010_004447
2010_004460
2010_004488
2010_004665
2010_004680
2010_004751
2010_004786
2010_004866
2010_005133
2010_005155
2010_005379
2010_005409
2010_005419
2010_005441
2010_005512
2010_005663
2010_005853
2010_005865
2010_005883
2010_005952
2010_005954
2010_006000
2010_006015
2010_006021
2011_000027
2011_000206
2011_000257
2011_000344
2011_000361
2011_000375
2011_000622
2011_000713
2011_000847
2011_000920
2011_000951
2011_000996
2011_001008
2011_001168
2011_001272
2011_001295
2011_001305
2011_001327
2011_001382
2011_001521
2011_001571
2011_001700
2011_001720
2011_001820
2011_002044
2011_002088
2011_002113
2011_002131
2011_002158
2011_002163
2011_002185
2011_002301
2011_002318
2011_002324
2011_002387
2011_002433
2011_002559
2011_002560
2011_002590
2011_002890
2011_002911
2011_002920
2011_002940
2011_002966
2011_002967
2011_002974
2011_003010
2011_003158
2011_003262
