2007_000648
2007_000768
2007_001595
2007_002024
2007_002216
2007_003715
2007_004065
2007_005262
2007_006317
2007_007003
2007_007398
2007_007480
2007_007591
2007_007908
2007_009832
2008_000032
2008_000132
2008_000238
2008_000252
2008_000982
2008_001022
2008_001820
2008_001842
2008_002179
2008_002412
2008_002451
2008_003060
2008_003067
2008_003266
2008_003302
2008_003321
2008_003373
2008_003381
2008_003489
2008_003691
2008_003811
2008_003924
2008_004055
2008_004088
2008_004613
2008_004614
2008_004679
2008_004725
2008_004794
2008_004844
2008_004866
2008_004976
2008_005074
2008_005139
2008_005196
2008_005266
2008_005277
2008_005350
2008_005360
2008_005720
2008_005761
2008_005878
2008_005891
2008_005933
2008_005984
2008_006359
2008_006483
2008_006530
2008_006635
2008_006748
2008_007056
2008_007254
2008_007352
2008_007356
2008_007375
2008_007488
2008_007515
2008_007635
2008_007641
2008_007872
2008_007931
2008_007969
2008_007997
2008_008066
2008_008080
2008_008097
2008_008113
2008_008120
2008_008234
2008_008281
2008_008343
2008_008549
2008_008598
2008_008674
2008_008683
2008_008684
2008_008701
2008_008705
2008_008706
2008_008719
2008_008748
2009_000006
2009_000027
2009_000054
2009_000060
2009_000089
2009_000097
2009_000104
2009_000135
2009_000140
2009_000176
2009_000199
2009_000203
2009_000239
2009_000405
2009_000408
2009_000519
2009_000532
2009_000557
2009_000558
2009_000568
2009_000617
2009_000648
2009_000708
2009_000886
2009_000945
2009_000960
2009_000990
2009_001044
2009_001083
2009_001091
2009_001098
2009_001113
2009_001138
2009_001148
2009_001159
2009_001197
2009_001237
2009_001326
2009_001354
2009_001366
2009_001472
2009_001590
2009_001614
2009_001633
2009_001674
2009_001675
2009_001707
2009_001734
2009_001752
2009_001811
2009_001822
2009_001847
2009_001897
2009_001910
2009_001967
2009_002052
2009_002057
2009_002066
2009_002105
2009_002126
2009_002128
2009_002152
2009_002203
2009_002271
2009_002348
2009_002398
2009_002436
2009_002457
2009_002505
2009_002512
2009_002517
2009_002532
2009_002566
2009_002570
2009_002621
2009_002626
2009_002843
2009_002853
2009_002876
2009_002933
2009_003018
2009_003053
2009_003067
2009_003200
2009_003276
2009_003383
2009_003385
2009_003422
2009_003447
2009_003458
2009_003461
2009_003491
2009_003555
2009_003566
2009_003592
2009_003614
2009_003636
2009_003669
2009_003710
2009_003757
2009_003781
2009_003916
2009_003969
2009_004018
2009_004037
2009_004040
2009_004052
2009_004055
2009_004187
2009_004197
2009_004231
2009_004258
2009_004276
2009_004290
2009_004295
2009_004328
2009_004350
2009_004369
2009_004374
2009_004383
2009_004417
2009_004440
2009_004567
2009_004667
2009_004670
2009_004681
2009_004829
2009_004836
2009_004871
2009_004947
2009_004962
2009_005060
2009_005168
2009_005201
2009_005279
2009_005293
2010_000069
2010_000148
2010_000165
2010_000187
2010_000376
2010_000480
2010_000524
2010_000603
2010_000689
2010_000726
2010_000770
2010_000797
2010_000855
2010_000947
2010_001087
2010_001204
2010_001288
2010_001364
2010_001410
2010_001453
2010_001458
2010_001630
2010_001640
2010_001650
2010_001732
2010_001771
2010_001808
2010_001892
2010_001982
2010_002102
2010_002203
2010_002218
2010_002263
2010_002356
2010_002413
2010_002438
2010_002758
2010_002774
2010_002978
2010_003040
2010_003057
2010_003173
2010_003179
2010_003534
2010_003562
2010_003635
2010_003855
2010_003877
2010_003893
2010_003936
2010_004180
2010_004263
2010_004367
2010_004554
2010_004558
2010_004588
2010_004594
2010_004616
2010_004625
2010_004627
2010_004637
2010_004696
2010_004735
2010_004806
2010_004844
2010_004903
2010_004971
2010_004997
2010_005041
2010_005080
2010_005123
2010_005277
2010_005389
2010_005415
2010_005457
2010_005502
2010_005527
2010_005596
2010_005636
2010_005756
2010_005959
2011_000007
2011_000025
2011_000048
2011_000090
2011_000095
2011_000138
2011_000181
2011_000208
2011_000258
2011_000267
2011_000369
2011_000541
2011_000551
2011_000559
2011_000703
2011_000767
2011_000804
2011_000901
2011_001015
2011_001105
2011_001146
2011_001227
2011_001255
2011_001270
2011_001355
2011_001411
2011_001479
2011_001519
2011_001536
2011_001747
2011_001826
2011_001870
2011_001949
2011_001964
2011_002046
2011_002079
2011_002215
2011_002227
2011_002330
2011_002384
2011_002457
2011_002460
2011_002629
2011_002687
2011_002780
2011_002826
2011_002925
2011_002932
2011_002944
2011_002956
2011_003086
2011_003089
2011_003109
2011_003247
